0 0 0  0  0  0  0  0  0  0  0  0 0 0 0 0 0 0 0 0 0 0  0  0  0 0 0 0 0 0 0 0 
0 0 1  1  1  1  1  1  1  1  1  1 1 0 0 0 0 0 0 0 0 0  0  0  0 0 0 0 0 0 0 0
0 0 1 15 16 17 18 19 20 21 22 23 1 0 0 0 0 0 0 0 0 0  0  0  0 0 0 0 0 0 0 0
0 0 1 24 25 26 27 28 29 30 31 32 1 0 0 0 0 0 0 0 0 0  0  0  0 0 0 0 0 0 0 0
0 0 1 33 34 35 36 37 38 39 40 41 1 0 0 0 0 0 0 0 0 0  3  4  5 0 0 0 0 0 0 0
0 0 1  1  1  1  1  1  1  1  1  1 1 0 0 0 0 0 0 0 0 0  6  7  8 0 0 0 0 0 0 0
0 0 0  1  1  1  1  1  1  1  1  1 0 0 0 0 0 0 0 0 0 0  9 10 11 0 0 0 0 0 0 0 
0 0 0  0  0  0  2  2  2  0  0  0 0 0 0 0 0 0 0 0 0 0 12 13 14 0 0 0 0 0 0 0 
0 0 0  0  0  0  1  1  1  1  1  1 1 1 1 1 1 1 1 1 1 1  1  1  1 0 0 0 0 0 0 0
0 0 0  0  0  0  1  1  1  1  1  1 1 1 1 1 1 1 1 1 1 1  1  1  1 0 0 0 0 0 0 0
0 0 0  0  0  0  0  0  0  0  0  0 0 0 0 0 0 0 0 0 0 0  0  0  0 0 0 0 0 0 0 0
0 0 0  0  0  0  0  0  0  0  0  0 0 0 0 0 0 0 0 0 0 0  0  0  0 0 0 0 0 0 0 0