0 0 0  0  0  0  0  0  0  0  0  0 0 0 0 0 0 0 0 0 0 0  0  0  0 0  
0 0 1  1  1  1  1  1  1  1  1  1 1 0 0 0 0 0 0 0 0 0  0  0  0 0 
0 0 1 41 42 43 44 45 46 47 48 49 1 0 0 0 0 0 0 0 0 0  0  0  0 0 
0 0 1 50 51 52 53 54 55 56 57 58 1 0 0 0 0 0 0 0 0 0  0  0  0 0 
0 0 1 59 60 61 62 63 64 65 66 67 1 0 0 0 0 0 0 0 0 0  8  9 10 0 
0 0 1  1  1  1  1  1  1  1  1  1 1 0 0 0 0 0 0 0 0 0 11 12 13 0 
0 0 0  1  1  1  1  1  1  1  1  1 0 0 0 0 0 0 0 0 0 0 14 15 16 0  
0 0 0  0  0  0  1  1  1  0  0  0 0 0 0 0 0 0 0 0 0 0 17 18 19 0  
0 0 0  0  0  0  1  1  1  1  1  1 1 1 1 1 1 1 1 1 1 1  1  1  1 0 
0 0 0  0  0  0  1  1  1  1  1  1 1 1 1 1 1 1 1 1 1 1  1  1  1 0
0 0 0  0  0  0  0  0  0  0  0  0 0 0 0 0 0 0 0 0 0 0  0  0  0 0 
0 0 0  0  0  0  0  0  0  0  0  0 0 0 0 0 0 0 0 0 0 0  0  0  0 0 
