0 0 0 0  0  0  0  0  0  0  0  0  0  0  5  0  0  0   4  0  0  0  0  0  0  0  0  0  0 0 0 0
0 0 0 0  0  0  0  27 16 16 16 16 16 16 18 0  0  0  17 16 16 16 16 16 16 16 16 28  0 0 0 0
0 0 0 0  0  0  27 18  2  2  2  2  2  8  3 0  0  0   1  8  2  2  2  2  2  2  2 17 28 0 0 0
0 0 0 0  16 16 18  3  2  2  2  2  2  8  3 0  0  0   1  8  2  2  2  2  2  2  2  1  4 0 0 0
0 0 0 0   9 10  3  3 13 13 13 13 13 19 14 0  0  0  12 19 13 13 13 13 13 13 13  1  4 0 0 0
0 0 0 0  20 21  3 14 24 24 24 24 24 24 24 23 23 23 24 24 24 24 24 24 24 24 24 12  4 0 0 0
0 0 0 0  31 32 14 24 24 24 24 24 24 24 11 23 23 23 23 23 23 23 23 23 26 24 24 24  4 0 0 0
0 0 0 0  23 23 23 23 23 23 23 23 23 23 23 23 23 23 23 23 23 23 23 23 22 24 24 24  4 0 0 0
0 0 0 0  23 23 23 23 23 23 23 23 23 23 23 23 23 25 24 24 24 24 24 24 24 24 24 24  4 0 0 0
0 0 0 0  15 15 15  7 24 24 24 24 24 24 24 24 24 24 24 24 24 24 24 24 24 24  6 15 30 0 0 0
0 0 0 0  0  0  0   5 24 24 24 24 24 24 24 24 24 24 24 24 24 24 24  6 15 15 30  0  0 0 0 0
0 0 0 0  0  0  0  29 15 15 15 15 15 15 15 15 15 15 15 15 15 15 15 30  0  0  0  0  0 0 0 0