0 0 0  0  0  0  0  0  0  0  0  0 0 0 0 0 0 0 0 0 0 0  0  0  0 0 0 0 0 0 0 0 
0 0 1  1  1  1  1  1  1  1  1  1 1 0 0 0 0 0 0 0 0 0  0  0  0 0 0 0 0 0 0 0
0 0 1 20 21 22 23 24 25 26 27 28 1 0 0 0 0 0 0 0 0 0  0  0  0 0 0 0 0 0 0 0
0 0 1 29 30 31 32 33 34 35 36 37 1 0 0 0 0 0 0 0 0 0  0  0  0 0 0 0 0 0 0 0
0 0 1 38 39 40 41 42 43 44 45 46 1 0 0 0 0 0 0 0 0 0  8  9 10 0 0 0 0 0 0 0
0 0 1  1  1  1  1  1  1  1  1  1 1 0 0 0 0 0 0 0 0 0 11 12 13 0 0 0 0 0 0 0
0 0 0  1  1  1  1  1  1  1  1  1 0 0 0 0 0 0 0 0 0 0 14 15 16 0 0 0 0 0 0 0 
0 0 0  0  0  0  2  2  2  0  0  0 0 0 0 0 0 0 0 0 0 0 17 18 19 0 0 0 0 0 0 0 
0 0 0  0  0  0  1  1  1  1  1  1 1 1 1 1 1 1 1 1 1 1  1  1  1 0 0 0 0 0 0 0
0 0 0  0  0  0  1  1  1  1  1  1 1 1 1 1 1 1 1 1 1 1  1  1  1 0 0 0 0 0 0 0
0 0 0  0  0  0  0  0  0  0  0  0 0 0 0 0 0 0 0 0 0 0  0  0  0 0 0 0 0 0 0 0
0 0 0  0  0  0  0  0  0  0  0  0 0 0 0 0 0 0 0 0 0 0  0  0  0 0 0 0 0 0 0 0