0  0  0  0  0  0  0  0  0  0  0 51  0  0  0  50  0  0  0  0  0  0  0  0  0  0  
0  0  0  0 73 62 62 62 62 62 62 64  0  0  0  63 62 62 62 62 62 62 62 62 74  0 
0  0  0  73 64 48 48 48 48 48 54 49 0  0  0  47 54 48 48 48 48 48 48 48 63 74
62 62 62 64 49 48 48 48 48 48 54 49 0  0  0  47 54 48 48 48 48 48 48 48 47 50
48 55 56 49 49 59 59 59 59 59 65 60 0  0  0  58 65 59 59 59 59 59 59 59 47 50
48 66 67 49 60 70 70 70 70 70 70 70 69 69 69 70 70 70 70 70 70 70 70 70 58 50
59 77 78 60 70 70 70 70 70 70 70 57 69 69 69 69 69 69 69 69 69 72 70 70 70 50
69 69 69 69 69 69 69 69 69 69 69 69 69 69 69 69 69 69 69 69 69 68 70 70 70 50
69 69 69 69 69 69 69 69 69 69 69 69 69 69 71 70 70 70 70 70 70 70 70 70 70 50
61 61 61 61 53 70 70 70 70 70 70 70 70 70 70 70 70 70 70 70 70 70 70 52 61 76
0  0  0  0  51 70 70 70 70 70 70 70 70 70 70 70 70 70 70 70 52 61 61 76  0  0
0  0  0  0  75 61 61 61 61 61 61 61 61 61 61 61 61 61 61 61 76  0  0  0  0  0