42 42 42 42 42 42 42 42 42 42 42   5  6  7 42 42 42  5  6  7 42 42 42  5  6  7  42 42 42   5  6  7 
42 1  8  9  10   1  1  1  2  3  4  16 17 18  2  3  4 16 17 18  2  3  4 16 17 18  2  3  4  16 17 18
42 1  19 20 21   1  1  1  13 14 15 27 28 29 13 14 15 27 28 29 13 14 15 27 28 29 13 14 15  27 28 29
42 1  30 31 32   1  1  1  24 25 26 38 39 40 24 25 26 38 39 40 24 25 26 38 39 40 24 25 26  38 39 40
42 1  41 42 43   1  1  1  35 36 37 49 50 51 35 36 37 49 50 51 35 36 37 49 50 51 35 36 37  49 50 51
42 12 52 53 54 12 12 12 46 47 48 23 23 23 46 47 48 23 23 23 46 47 48 23 23 23 46 47 48  23  23  23 
42 22 33 22 33 22 33 22 55 56 57 34 44 34 55 56 57 34 44 34 55 56 57 34 44 34 55 56 57  34  44  34 
42 33 22 33 22 33 22 33  0 11  0 44 34 44  0 11  0 44 34 44  0 11  0 44 34 44 0 11   0  44  34  44 
42 22 33 22 33 22 33 22 11  0 11 34 44 34 11  0 11 34 44 34 11  0 11 34 44 34 11  0 11  34  44  34
42 33 22 33 22 33 22 33  0 11  0 44 34 44  0 11  0 44 34 44 0 11  0  44 34 44 0 11   0  44  34  44
42 22 33 22 33 22 33 22 11  0 11 34 44 34 11  0 11 34 44 34 11  0 11 34 44 34 11  0 11  34  44  34
42 42 42 42 42 42 42 42 42 42 42 42 42 42 42 42 42 42 42 42 42 42 42 42 42 42 42 42 42  42  42  42